hitch	hitch
four	four
sleep	sleep
oldest	oldest
whose	whose
risk	risk
downstream	downstream
rise	rise
distort	distortion
pigment	pigment
upstream	upstream
affect	affect
ala	ala
vast	vast
anemia	anemia
disturb	disturb
frozen	frozen
vector	vector
cholesterol	cholesterol
bacon	bacon
direct	direct
nail	nail
second	second
hundredfold	hundredfold
chem	chem
even	even
employ	employ
worsen	worsen
neg	neg
bipolar	bipolar
conduct	conduct
new	new
med	med
centric	centric
seventh	seventh
men	men
chine	chines
met	met
china	china
paraffin	paraffin
interpret	interpret
acceptor	acceptor
daughter	daughter
settler	settler
mutagen	mutagen
permit	permit
interferon	interferon
golden	golden
brought	brought
total	total
unit	unit
would	would
call	call
recommend	recommend
strike	strike
type	type,typing
relax	relax
adult	adult
loss	loss
pouch	pouch
must	must
word	word
work	work
mammalian	mammalian
erg	erg,ergs
era	era
elbow	elbow
root	root
newfoundland	newfoundland
give	give
impair	impair
malign	malign
liter	liter
caution	caution
want	want
end	end
revisit	revisit
hot	hot
morbid	morbid
toxic	toxic
gate	gate
widespread	widespread
ancestor	ancestor
wolfram	wolfram
fever	fever
earlier	earlier
patella	patella
lac	lac
modest	modest
lay	lay
lap	lap
parallel	parallel
attempt	attempt
third	third
maintain	maintain
environ	environment
first	first
order	order
blind	blind
deform	deform
fall	fall
incid	incident
japan	japan
vita	vita
digest	digest
ligand	ligand
fit	fit
mintier	mintier
fix	fix
better	better
persist	persist
hidden	hidden
fragment	fragment
enrich	enrich
safe	safe
accrual	accrual
protean	protean
break	break
band	band
interrupt	interrupt
bronchial	bronchial
sixteen	sixteen
bani	bani
anion	anion
oxygen	oxygen
side	side
bone	bone
mean	mean
concord	concord
knockout	knockout
extract	extract
hypothyroid	hypothyroid
depress	depress
network	network
gradient	gradient
crucial	crucial
content	content
millennium	millennium
adapt	adapt
linear	linear
midpoint	midpoint
free	free
standard	standard
salient	salient
mononuclear	mononuclear
kit	kit
convent	convent
renew	renew
isl	isl
regress	regress
onto	onto
rang	rang
render	render
grade	grade
wasp	wasp
vitro	vitro
rank	rank
restrict	restrict,restriction
wash	wash
instruct	instruct
neuromuscular	neuromuscular
toe	toe
urban	urban
rest	rest
tool	tool
western	western
somewhat	somewhat
peculiar	peculiar
symptom	symptom
target	target
zero	zero
project	project
matter	matter
expo	expos
iron	iron
design	design
provis	provision
fashion	fashion
modern	modern
spectrum	spectrum
rat	rat
manner	manner
seen	seen
seem	seem
seek	seek
ray	ray
latter	latter
thorough	thorough
transmit	transmit
cleft	cleft
blue	blue
though	though
object	object
reticulum	reticulum
regular	regular
carcinoma	carcinoma
vaccinia	vaccinia
breakpoint	breakpoint
phase	phase
coil	coil
contain	contain
metal	metal
dog	dog
doe	doe
bracket	bracket
aunt	aunt
notion	notion
came	came
random	random
pave	pave
radio	radio
ulcer	ulcer
lethal	lethal
latent	latent
explain	explain
sugar	sugar
rich	rich
stop	stop
fluid	fluid
coast	coast
congruent	congruent
report	report
reconstruct	reconstruct
emb	embed
colloid	colloid
patch	patch
twice	twice
chromatograph	chromatograph
respond	respond
resist	resist
result	result
fail	fail
optimum	optimum
best	best
subject	subject
epithelium	epithelium
away	away
mug	mug
score	score
finger	finger
drawn	drawn
approach	approach
ire	ire
accord	accord
triplet	triplet
extend	extend
weak	weak
androgen	androgen
southeast	southeast
extent	extent
toler	tolerance
bangkok	bangkok
protect	protect
cow	cow
cox	cox
ventricular	ventricular
logic	logic
widen	widen
trunk	trunk
height	height
stillborn	stillborn
wider	wider
ether	ether
speak	speak
recur	recur
union	union
plantar	plantar
three	three
much	much
interest	interest
basic	basic
life	life
retrospect	retrospect
eastern	eastern
suppress	suppress
worker	worker
bladder	bladder
uncommon	uncommon
fibroblast	fibroblast
child	child
inhibit	inhibit
plasma	plasma
dissect	dissect
aim	aim
calcium	calcium
near	near
viii	viii
occas	occasion
aid	aid
anchor	anchor
seven	seven
pyramid	pyramid
eighteen	eighteen
cone	cone
disappear	disappear
descent	descent
perform	perform
suggest	suggest
make	make
complex	complex
descend	descend
welsh	welsh
swell	swell
rain	rain
hand	hand
fuse	fuse
overt	overt
paediatrician	paediatrician
inherit	inherit
contact	contact
greatest	greatest
mother	mother
jean	jean
quotient	quotient
stringent	stringent
protocol	protocol
background	background
photo	photo
rodent	rodent
human	human
yet	yet
thyroid	thyroid
ham	ham
neoplasm	neoplasm
east	east
hat	hat
gave	gave
toxin	toxin
clonal	clonal
fusion	fusion
natal	natal
birth	birth
danish	danish
lymphoma	lymphoma
apart	apart
specif	specif
nude	nude
manual	manual
right	right
old	old
deal	deal
deaf	deaf
maxim	maxim
rever	revers
born	born
intern	intern
flatten	flatten
cooper	cooper
flux	flux
subclass	subclass
cord	cord
core	core
dental	dental
pose	pose
confer	confer
promot	promoter
post	post
surround	surround
commit	commit
bound	bound
son	son
segment	segment
support	support
transform	transform
avail	avail
way	way
lowest	lowest
head	head
medium	medium
form	form
offer	offer
epsilon	epsilon
peninsula	peninsula
heat	heat
hear	hear
true	true
absent	absent
counsel	counsel
myopia	myopia
maximum	maximum
vivo	vivo
crystal	crystal
absenc	absence
temper	temper
trio	trio
adopt	adopt
classic	classic
stronger	stronger
abstract	abstract
proven	proven
gland	gland
exist	exist
check	check
melanoma	melanoma
inborn	inborn
excel	excel
role	role
test	test
implant	implant
smell	smell
node	node
cleric	cleric
handicap	handicap
diet	diet
fell	fell
consid	consider
cleaver	cleaver
younger	younger
faster	faster
hemophilia	hemophilia
pseudo	pseudo
rough	rough
teeth	teeth
nuclei	nuclei
biotin	biotin
concept	concept
chain	chain
skip	skip
global	global
rod	rod
mild	mild
skin	skin
primer	primer
milk	milk
discern	discern
uneven	uneven
depend	depend
zone	zone
father	father
southwest	southwest
methyl	methyl
yeast	yeast
embark	embark
kitten	kitten
cook	cook
exact	exact
level	level
die	die
brother	brother
magnet	magnet
gut	gut
round	round
prevent	prevent
oncogen	oncogene
slower	slower
pore	pore
sign	sign
cost	cost
run	run
bacteria	bacteria
appear	appear
current	current
suspect	suspect
sixfold	sixfold
defici	deficiency,deficient
water	water
entertain	entertain
splice	splice
address	address
along	along
box	box
boy	boy
precursor	precursor
shift	shift
trial	trial
throughput	throughput
cinnamon	cinnamon
cyst	cyst
influx	influx
orient	orient
regardless	regardless
extra	extra
prefer	prefer
technetium	technetium
marker	marker
transplant	transplant
prove	prove
subvert	subvert
visit	visit
live	live
criteria	criteria
black	black
reduct	reduct
diurnal	diurnal
club	club
clue	clue
visual	visual
tandem	tandem
effort	effort
logarithm	logarithm
focu	focus
cat	cat
foci	foci
cam	cam
heart	heart
predict	predict
chip	chip
agent	agent
critic	critic
occur	occur
alway	alway
flank	flank
criterion	criterion
fourth	fourth
pathway	pathway
undertook	undertook
map	map
product	product
may	may
max	max
clone	clone
fed	fed
southern	southern
dopa	dopa
date	date
drastic	drastic
suck	suck
data	data
grow	grow
man	man
stress	stress
neck	neck
liquid	liquid
wheelchair	wheelchair
corona	corona
inform	inform
switch	switch
deposit	deposit
tall	tall
gradual	gradual
brain	brain
still	still
conjunct	conjunct
group	group
thumb	thumb
window	window
main	main
cutter	cutter
chromatin	chromatin
nation	nation
lesser	lesser
half	half
discuss	discuss
possess	possess
term	term
name	name
bisect	bisect
quarter	quarter
el	els
domain	domain
saliva	saliva
year	year
happen	happen
lesson	lesson
shown	shown
space	space
trauma	trauma
dutch	dutch
sensor	sensor
correct	correct
diseas	disease
million	million
envelop	envelop
care	care
urea	urea
turn	turn
place	place
childhood	childhood
frequent	frequent
lambda	lambda
origin	origin
distal	distal
housekeep	housekeep
one	one
long	long
array	array
open	open
size	size
given	given
silent	silent
district	district
arch	arch
breed	breed
white	white
cite	cite
friend	friend
hue	hue
fraction	fraction
hum	hum
enigma	enigma
meiotic	meiotic
disequilibrium	disequilibrium
wide	wide
recruit	recruit
posit	posit
prospect	prospect
angel	angel
sac	sac
pro	pro
dash	dash
sat	sat
consortium	consortium
note	note
take	take
destroy	destroy
wonder	wonder
channel	channel
begin	begin
pain	pain
trace	trace
normal	normal
buffer	buffer
compress	compress
beta	beta
tract	tract
pair	pair
knee	knee
latex	latex
tendon	tendon
synonym	synonym
renal	renal
enamel	enamel
later	later
drive	drive
tooth	tooth
cortex	cortex
pattern	pattern
salt	salt
slope	slope
cobra	cobra
show	show
cornea	cornea
atom	atom
threshold	threshold
fifth	fifth
slot	slot
slow	slow
ratio	ratio
activ	activators,activated
threefold	threefold
helix	helix
stain	stain
extracellular	extracellular
cannot	cannot
theta	theta
gel	gel
prime	prime
reveal	reveal
median	median
yield	yield
cystic	cystic
cochlea	cochlea
vision	vision
burst	burst
eighteenth	eighteenth
progress	progress
diver	divers
concern	concern
detect	detect
review	review
label	label
enough	enough
import	import
across	across
fibular	fibular
august	august
parent	parent,parents
comp	comp
screen	screen
pluck	pluck
spare	spare
come	come
reaction	reaction
region	region
contract	contract
among	among
cancer	cancer
color	color
overview	overview
period	period
exploit	exploit
anti	anti
amino	amino
turkey	turkey
stretch	stretch
skew	skew
mark	mark
reflex	reflex
schoolboy	schoolboy
histogram	histogram
thousand	thousand
photon	photon
muscular	muscular
former	former
pilot	pilot
case	case,cases
kappa	kappa
tribal	tribal
cash	cash
margin	margin
canon	canon
strain	strain
sudden	sudden
protein	protein
par	par
develop	develop,development
author	author
media	media
medic	medic
speech	speech
subunit	subunit
week	week
exhaust	exhaust
oil	oil
closest	closest
nest	nest
assist	assist
ninefold	ninefold
companion	companion
driven	driven
devoid	devoid
vestibular	vestibular
moder	moder
reagent	reagent
macro	macro
without	without
model	model
edema	edema
ninth	ninth
imprint	imprint
kill	kill
multiplex	multiplex
aspect	aspect
polish	polish
ethyl	ethyl
death	death
asthma	asthma
except	except
instrument	instrument
treatment	treatment
disrupt	disrupt
real	real
psi	psi
around	around
read	read
specimen	specimen
dark	dark
traffic	traffic
world	world
postal	postal
twin	twin
benefit	benefit
either	either
colon	colon
inter	inter
afflict	afflict
drosophila	drosophila
nucleic	nucleic
racial	racial
intact	intact
interleukin	interleukin
gross	gross
confirm	confirm
tube	tube
moor	moor
deficit	deficit
refer	refer
power	power
sixth	sixth
ration	ration,rational
broken	broken
glycerol	glycerol
keratin	keratin
comparison	comparison
central	central
island	island
tumor	tumor,tumors
act	act
trypsin	trypsin
bond	bond
invert	invert
aortic	aortic
reassess	reassess
spinal	spinal
asymptomat	asymptomatic
area	area
jigsaw	jigsaw
hex	hex
start	start
low	low
valley	valley
regard	regard
jun	jun
femal	female
amongst	amongst
posterior	posterior
lymph	lymph
mice	mice
longer	longer
regimen	regimen
grass	grass
pulp	pulp
expect	expect
gone	gone
certain	certain
deep	deep
stigmata	stigmata
sheath	sheath
encompass	encompass
proport	proportion
intra	intra
fill	fill
diarrhea	diarrhea
green	green
abolish	abolish
tight	tight
valid	valid
poor	poor
symbol	symbol
time	time
drift	drift
peak	peak
pool	pool
palat	palate
gastric	gastric
mimic	mimic
mast	mast
mass	mass
oral	oral
sci	sci
founder	founder
protract	protract
lack	lack
month	month
disc	disc
zinc	zinc
follow	follow
settlement	settlement
children	children
alp	alp
emphysema	emphysema
program	program
present	present
sustain	sustain
woman	woman
far	far
fat	fat
candid	candid
bleach	bleach
salmonella	salmonella
bottleneck	bottleneck
strand	strand
induct	induct
list	list
adjust	adjust
small	small
mammal	mammal
mount	mount
dimens	dimension
nonrandom	nonrandom
ten	ten
past	past
rate	rate
fiber	fiber
phage	phage
pass	pass
hamper	hamper
gonad	gonad
sub	sub
section	section
ovarian	ovarian
overload	overload
delet	deletion
method	method
contrast	contrast
movement	movement
full	full
malaria	malaria
excess	excess
strong	strong
search	search
outgrowth	outgrowth
prior	prior
amount	amount
hamster	hamster
action	action
narrow	narrow
cataract	cataract,cataracts
via	via
depart	depart
transit	transit,transition
vii	vii
put	put
famili	family,families
viz	viz
establish	establish
select	select
eye	eye
proceed	proceed
distinct	distinct
two	two
viru	virus
morn	morn
taken	taken
minor	minor
site	site,sites
particular	particular
known	known
nineteen	nineteen
town	town
none	none
endpoint	endpoint
hour	hour
cluster	cluster
remain	remain
nine	nine
learn	learn
male	male
prompt	prompt
buttress	buttress
scan	scan
share	share
retest	retest
accept	accept
cation	cation
minimum	minimum
partner	partner
sharp	sharp
huge	huge
answer	answer
goal	goal
rather	rather
compel	compel
piebald	piebald
plant	plant
variant	variant,variants
reflect	reflect
fa	fas
catalog	catalog
blood	blood
unlink	unlink
short	short
uracil	uracil
coat	coat
spectra	spectra
spheric	spheric
egg	egg
infant	infant
help	help
soon	soon
mucosa	mucosa
thermal	thermal
paper	paper
suffer	suffer
cardiovascular	cardiovascular
sodium	sodium
inward	inward
late	late
negroid	negroid
might	might
alter	alter,altered
good	good
return	return
paraplegia	paraplegia
wast	wast
framework	framework
compound	compound
foot	foot
detach	detach
document	document
pregnant	pregnant
pregnanc	pregnancy
found	found
harm	harm
england	england
mental	mental
weight	weight
fish	fish
idea	idea
connect	connect
beyond	beyond
event	event
alcohol	alcohol
publish	publish
research	research
health	health
hill	hill
expans	expansion
asp	asp
solvent	solvent
risen	risen
lamina	lamina
reason	reason
base	base
airway	airway
ask	ask
bash	bash
diaspora	diaspora
undergo	undergo
assign	assign,assignment
feed	feed
copper	copper
major	major
perturb	perturb
number	number
done	done
construct	construct
miss	miss
differ	differ
interact	interact
least	least
checkpoint	checkpoint
mosaic	mosaic
molecular	molecular
store	store
relationship	relationship
bowel	bowel
facet	facet
basal	basal
dentist	dentist
part	part
albeit	albeit
kind	kind
grew	grew
toward	toward
comput	computer
exert	exert
globulin	globulin
defect	defect,defective
engulf	engulf
null	null
remodel	remodel
lie	lie
grandchildren	grandchildren
self	self
onset	onset
also	also
lip	lip
build	build
donor	donor
play	play
previou	previous
nasal	nasal
react	react
assoc	assoc
plan	plan
rho	rho
ileum	ileum
alpha	alpha
clear	clear
cover	cover
destruct	destruct
usual	usual
tuber	tuber
phenomenon	phenomenon
gold	gold
mongoloid	mongoloid
fine	fine
find	find
chimer	chimer
access	access
giant	giant
northern	northern
discord	discord
factor	factor
hip	hip
hit	hit
express	express
longest	longest
dose	dose
clot	clot
adulthood	adulthood
clinic	clinic
common	common
relentless	relentless
doublet	doublet
set	set
extensor	extensor
sex	sex
sen	sens
arm	arm
analog	analog
pneumonia	pneumonia
aqueduct	aqueduct
guinea	guinea
smallest	smallest
vascular	vascular
experi	experiment
milder	milder
complement	complement
sole	sole
blot	blot
rarer	rarer
distinguish	distinguish
zipper	zipper
popul	populations
cryptic	cryptic
last	last
context	context
whole	whole
load	load
point	point
northeastern	northeastern
newborn	newborn
vessel	vessel
zeta	zeta
throughout	throughout
coincid	coincident
sever	sever
intracellular	intracellular
due	due
strengthen	strengthen
secret	secret
threaten	threaten
ganglion	ganglion
infect	infect,infection,infections
convert	convert
gap	gap
gal	gal
understand	understand
liver	liver
gag	gag
bile	bile
uncertain	uncertain
solid	solid
straight	straight
behavior	behavior
error	error
loop	loop
pack	pack
kingdom	kingdom
herein	herein
confound	confound
rim	rim
eczema	eczema
chase	chase
twofold	twofold
glycogen	glycogen
minim	minim
belong	belong
ewe	ewe
shorter	shorter
benign	benign
ester	ester
conflict	conflict
higher	higher
optic	optic
alert	alert
triad	triad
stack	stack
focal	focal
recent	recent
lower	lower
older	older
person	person
elev	elev
swiss	swiss
effector	effector
shape	shape
cut	cut
cur	cur
homeland	homeland
format	format
big	big
formal	formal
knock	knock
success	success
semi	semi
spine	spine
signal	signal
manifest	manifest
collect	collect
rheumatoid	rheumatoid
hallmark	hallmark
often	often
creation	creation
back	back
understood	understood
strongest	strongest
palm	palm
mirror	mirror
syndrom	syndrome
scale	scale
fivefold	fivefold
per	per
scalp	scalp
patient	patient,patients
agreement	agreement
stem	stem
step	step
output	output
faith	faith
coexist	coexist
soft	soft
glaucoma	glaucoma
paroxysm	paroxysm
gamma	gamma
anterior	anterior
repair	repair
within	within
exceed	exceed
gaucher	gaucher
next	next
canal	canal
span	span
verbal	verbal
question	question
fast	fast
spar	spars
albumin	albumin
nodular	nodular
great	great
potassium	potassium
retina	retina
link	link
delta	delta
line	line
consist	consist
morocco	morocco
homo	homo
sum	sum
highlight	highlight
similar	similar
constant	constant
estrogen	estrogen
flow	flow
prevail	prevail
kidney	kidney
steeper	steeper
nab	nab
commonest	commonest
crypt	crypt
afford	afford
mock	mock
viral	viral
impress	impress
insect	insect
ago	ago
dystrophi	dystrophy
algorithm	algorithm
age	age
fresh	fresh
lariat	lariat
code	code
partial	partial
fecund	fecund
broader	broader
ammonia	ammonia
biol	biol
young	young
fatal	fatal
sent	sent
inject	inject
overgrowth	overgrowth
probe	probe
assay	assay
wave	wave
mous	mouse
electron	electron
cellular	cellular
molar	molar
northwestern	northwestern
stiff	stiff
harbor	harbor
gender	gender
fewer	fewer
race	race
smaller	smaller
antigen	antigen
lightest	lightest
jump	jump
fold	fold
reunion	reunion
acid	acid
odd	odd
index	index
cell	cell
impact	impact
unmask	unmask
led	led
lee	lee
sinu	sinus
youngest	youngest
tremor	tremor
fifteen	fifteen
implicit	implicit
remark	remark
larger	larger
survey	survey
insulin	insulin
implement	implement
gene	gene
fourfold	fourfold
danger	danger
lenticular	lenticular
motor	motor
limb	limb
causal	causal
ape	ape
use	use
chi	chi
chm	chm
germ	germ
eleven	eleven
doubt	doubt
stage	stage
sort	sort
trait	trait
mismatch	mismatch
transient	transient
armadillo	armadillo
rabbit	rabbit
iii	iii
women	women
account	account
augment	augment
smear	smear
meet	meet
inhibitor	inhibitor
scatter	scatter
proof	proof
control	control
iodid	iodide
weaker	weaker
process	process
pelvic	pelvic
loci	loci
high	high
slit	slit
tag	tag
slip	slip
locu	locus
sought	sought
serial	serial
weaken	weaken
fetu	fetus
pure	pure
six	six
serum	serum
delay	delay
trousseau	trousseau
instead	instead
filament	filament
lesion	lesion
attend	attend
leukemia	leukemia
hazard	hazard
ethnic	ethnic
glucos	glucose
marrow	marrow
physic	physic
bind	bind
sit	sit
robot	robot
element	element
allow	allow
breast	breast
move	move
sperm	sperm
perfect	perfect
superior	superior
outer	outer
decay	decay
chosen	chosen
lamp	lamp
vital	vital
therefor	therefor
suppressor	suppressor
junction	junction
greater	greater
frontal	frontal
innermost	innermost
mention	mention
snake	snake
fingerprint	fingerprint
day	day
assess	assess
profound	profound
edit	edit
mode	mode
receptor	receptor
subset	subset
globe	globe
static	static
tubular	tubular
special	special
matrix	matrix
repress	repress
venom	venom
rel	rel
ref	ref
red	red
obsess	obsess
franc	franc
spot	spot
fourteen	fourteen
unipolar	unipolar
fetal	fetal
likelihood	likelihood
bleed	bleed
mainland	mainland
could	could
keep	keep
counterpart	counterpart
length	length
mortal	mortal
retain	retain
south	south
embryo	embryo
manuscript	manuscript
collagen	collagen
hitherto	hitherto
cardiac	cardiac
ancient	ancient
monkey	monkey
strict	strict
unknown	unknown
system	system
attack	attack
lumen	lumen
final	final
pathogen	pathogen
prone	prone
goiter	goiter
diminish	diminish
structur	structure
charact	character
light	light
exhibit	exhibit
cytoplasm	cytoplasm
correspond	correspond
close	close
need	need
dementia	dementia
border	border
min	min
mid	mid
outward	outward
adjunct	adjunct
mix	mix
mechanist	mechanist
cofactor	cofactor
singl	single
unless	unless
eight	eight
hydroxyl	hydroxyl
corneal	corneal
transcript	transcript
class	class
dorsal	dorsal
placement	placement
spleen	spleen
bred	bred
request	request
face	face
fact	fact
recess	recess
chicken	chicken
antiserum	antiserum
ear	ear
jaw	jaw
rash	rash
prolong	prolong
platelet	platelet
sulfur	sulfur
anneal	anneal
local	local
hope	hope
insight	insight
starch	starch
lobe	lobe
familiar	familiar
arrhythmia	arrhythmia
bear	bear
joint	joint
bean	bean
cerebellar	cerebellar
portion	portion
organ	organ
upper	upper
monom	monomer
ascertain	ascertain
view	view
conform	conform
frame	frame
ocular	ocular
closer	closer
polymorph	polymorph,polymorphism
interview	interview
nuclear	nuclear
tend	tend
favor	favor
state	state
unravel	unravel
crude	crude
chemic	chemic
neither	neither
rigor	rigor
tent	tent
alveolar	alveolar
exam	exam
choroid	choroid
lecithin	lecithin
key	key
monitor	monitor
equal	equal
drug	drug
placebo	placebo
unclear	unclear
walk	walk
cousin	cousin
ataxia	ataxia
respect	respect
withdrawn	withdrawn
torsion	torsion
quit	quit
cent	cent
treat	treat
eightfold	eightfold
presenc	presence
lymphoid	lymphoid
bulk	bulk
spaniel	spaniel
bulb	bulb
arisen	arisen
multi	multi
novel	novel
laser	laser
align	align
wild	wild
layer	layer
mutant	mutant
motif	motif
almost	almost
neuron	neuron
non	non
dual	dual
sarcoma	sarcoma
situ	situ
cohort	cohort
mutat	mutation,mutations
cross	cross
autism	autism
member	member
fallopian	fallopian
largest	largest
infer	infer
difficult	difficult
phi	phi
fur	fur
absorb	absorb
upon	upon
effect	effect
ion	ion
never	never
crossbre	crossbreed
expand	expand
retard	retard
center	center
neural	neural
nevertheless	nevertheless
polyp	polyp
well	well
thought	thought
polym	polymer
undertaken	undertaken
subgroup	subgroup
spastic	spastic
less	less
hybrid	hybrid,hybridization
obtain	obtain
predilect	predilect
fibril	fibril
interim	interim
distant	distant
skill	skill
rapid	rapid
field	field
smith	smith
arrest	arrest
add	add
natl	natl
ado	ado
warrant	warrant
match	match
branch	branch
fate	fate
five	five
know	know
facial	facial
placenta	placenta
insert	insert,insertion
like	like
lost	lost
ring	ring
lose	lose
pretest	pretest
page	page
shed	shed
phenomena	phenomena
hair	hair
growth	growth
proper	proper
peter	peter
transport	transport
est	est
pinpoint	pinpoint
lead	lead
broad	broad
avoid	avoid
overlap	overlap
uvula	uvula
leader	leader
hinder	hinder
lipid	lipid
slight	slight
host	host
although	although
slug	slug
panel	panel
sister	sister
rare	rare
immobl	immobility
column	column
freedom	freedom
ingest	ingest
fear	fear
carrier	carrier,carriers
predictor	predictor
owe	owe
axon	axon
chronic	chronic
guard	guard
lung	lung
brush	brush
sander	sander
van	van
val	val
transfer	transfer
spread	spread
inasmuch	inasmuch
trigger	trigger
inner	inner
function	function
north	north
progenitor	progenitor
gait	gait
neutral	neutral
gain	gain
rectum	rectum
highest	highest
count	count
made	made
wise	wise
whether	whether
smooth	smooth
record	record
limit	limit
problem	problem
display	display
block	block
pit	pit
girl	girl
tenth	tenth
percent	percent
detail	detail
virtual	virtual
parathyroid	parathyroid
wing	wing
stat	stat
repeat	repeat
stay	stay
preform	preform
baker	baker
rule	rule
hiker	hiker
riboflavin	riboflavin
pupil	pupil
